111111111
10P0000E1
100000001
100000C01
111111111
