111111111111111111111111111
100000P00000000000000000001
1000E0000000000000000000001
100000000000000000000000001
100000111000111000000000001
100000010000100100000000001
100000010000100100000000001
100000010000111000001000001
101111000000000000001000001
1000C100000000000000111E111
111111111111111111111111111
